###############################
#p  f  ** *  1 *   *  * * *   #
# # # #*# # #*#*# # # #*#*#*# #
#  b*     ***  *      *   * * #
# # # # # #*# # #*#*# # # # #*#
#s         x **  *  *         #
# # # # # # # # # #*# #*# # # #
#*  *      *  *      *        #
# # # # #*# # # #*#*# # # # # #
#*    **  *       *           #
# #*# # # # # # #*# # # # # # #
#           *   *  *          #
###############################