###############################
#p  f  ** *    *   *  * * *   #
# # # #*# # #*#*# # # #*#*#*# #
#  b*     ***  *      *   * * #
# # # # # #*# # #*#*# # # # #*#
#s         x **  *  *         #
# # # # # # # # # #*# #*# # # #
#*  *      *  *      *        #
# # # # #*# # # #*#*# # # # # #
#*    **  *       *           #
# #*# # # # # # #*# # # # # # #
#       1   *   *  *          #
###############################